12, 25
0, 2, 1, 1, 1, 7, 1, 1, 1, 1, 1, 1, 1, 5, 1, 1, 1, 1, 1, 1, 1, 1, 1, 2, 0
1, 2, 1, 6, 1, 1, 1, 1, 1, 1, 10, 10, 10, 1, 1, 1, 1, 1, 1, 5, 1, 6, 1, 5, 1
6, 2, 1, 0, 0, 0, 10, 10, 10, 10, 1, 1, 1, 10, 10, 10, 10, 10, 10, 0, 0, 0, 1, 2, 6
1, 2, 1, 0, 5, 0, 1, 4, 1, 1, 1, 1, 1, 1, 1, 1, 1, 4, 1, 0, 7, 0, 1, 2, 1
10, 10, 1, 1, 3, 1, 1, 1, 1, 1, 1, 1, 1, 1, 5, 1, 1, 1, 1, 1, 3, 1, 1, 10, 10
1, 2, 1, 1, 3, 7, 1, 1, 1, 1, 0, 1, 0, 1, 1, 4, 1, 1, 1, 7, 3, 1, 5, 2, 1
1, 2, 5, 1, 3, 1, 1, 5, 1, 1, 3, 4, 3, 1, 1, 1, 1, 1, 1, 1, 3, 1, 1, 2, 1
0, 2, 1, 1, 3, 1, 1, 1, 1, 1, 3, 1, 3, 1, 1, 1, 1, 1, 1, 1, 3, 1, 1, 2, 0
0, 2, 1, 10, 10, 10, 1, 0, 0, 0, 0, 0, 0, 0, 0, 0, 0, 0, 1, 10, 10, 10, 1, 2, 0
0, 2, 1, 1, 3, 1, 1, 0, 7, 0, 7, 0, 7, 0, 7, 0, 7, 0, 1, 1, 3, 1, 1, 2, 0
0, 2, 7, 1, 3, 1, 1, 2, 2, 2, 2, 2, 2, 2, 2, 2, 2, 2, 1, 1, 3, 1, 7, 1, 0
0, 0, 1, 1, 3, 1, 5, 2, 2, 5, 2, 2, 2, 2, 2, 5, 2, 2, 5, 1, 3, 1, 1, 0, 0